   1111111111111111111111
   1         e          1
   1 111 111111 1111111 1
   1 111    111     111 1
  11     11     111     11
  1  1 1    111 1   1 1  1
  1 11 11 1 111 1  11 11 1
  1   s   1 111 1  e o   1
  1 11 11 1        11 11 1
  1  1 1  1 111111  1 1  1
  11   e 11     11      11
   1 111     11     111 1
   1 1111111 111111 111 1
   1                    1
   1111111111111111111111
