  11111111111111111111111
  1                     1
  1 111 1111111 1111111 1
  1 111     111     111 1
  1 111 111 111 111 111 1
  1     111     111     1
111 1 1 1111111 111 1 1 111
1   1 1      e  1   1 1   1
1 111 111 1 111 1 111 111 1
1    s    1e111e1         1
1 111 111 1 111 1 111 111 1
1   1 1   1  e      1 1   1
111 1 1 111 1111111 1 1 111
  1     111     111     1
  1 111 111 111 111 111 1
  1 111     111     111 1
  1 1111111 1111111 111 1
  1                     1
  11111111111111111111111
