111111111111111111111111111
1                         1
1 11111111111 11111111111 1
1 1          hb         1 1
1 1 1 1111111 111111111 1 1
1 1  s                1 1 1 
1 1 1 1111111b1111111 1 1 1
1 1 1 1      h      1 1 1 1
1b1 1 1 11111111111 1 1 1 1
1h   hb 1         1  h   h1
1 1 1 1 11111111111 1b1 1b1
1 1 1 1      h      1 1 1 1
1 1 1 1111111b1111111 1 1 1
1 1 1                 1 1 1
1 1 111111111 111111111 1 1
1 1          h          1 1
1 11111111111b11111111111 1
1                        o1
111111111111111111111111111


