111111111111111111111111111
1                         1
1 11111111111 11111111111 1
1 1          r          1 1
1 1 1 1111111 111111111 1 1
1 1  s              e 1 1 1 
1 1 1 1111111 1111111 1 1 1
1 1 1 1      u      1 1 1 1
1 1 1 1 11111111111 1 1 1 1
1u    l 1         1    e d1
1 1 1 1 11111111111 1u1 1 1
1 1 1 1      d      1 1 1 1
1 1 1 1111111 1111111 1e1 1
1 1 1   e             1 1 1
1 1 111111111 111111111 1 1
1 1          d          1 1
1 11111111111 11111111111 1
1         e              o1
111111111111111111111111111


