

         1111
        1    1
   1   1  1 1 11111111111
    111    s             1
   1   1  1 1 1111111111  1
        1    1          1  1
         1111            1  1
                          1 1
     11111111111          1 1
    1          e1         1 1
   1  111111111  1        1 1
  1  1         1  1       1 1
  1 1           1  1     1  1
  1 1            1  1   1  1
  1 1             1  111  1
  1 1              1     1
  1  1              11111
   1  1111111111111111111
    1                   o1
     11111111111111111111
