  11111111111111111111111
  1          e          1
  1 1111111111111111111 1
  1 1                 1 1
  1 1 111111111111111 1 1
  1 1 1     1 1     1 1 1
  1 1 1 1 111 111 1 1 1 1
  1 1 1 1    o  1 1 1 1 1
  1 1 1 1 111 111 1 1 1 1
  1 1 1 1   1 1   1 1 1 1
  1 1 1 1111111 111 1 1 1
  1 1 1   1  e  1   1 1 1
  1 1 111 1 11111 111 1 1
  1 1 111   1     111 1 1
  1 1 111111111 11111 1 1
  1 1e        1      e1 1
  1 111111111 111111111 1
  1           1s        1
  11111111111111111111111
