 11111         1111111
 1    1        1     1
 111   1       111 111
   1    1        1 1
1111     111111111 111
1                     1
11 111 1  11111111 11  1     
 1 1 1 11  1     1 1 1  1
 1 1 1 1 1  1    1 1  1 1
 1 1 1 1  1  1   1 1  1 1
 1 1 1 1   1  1  1 1  1 1
 1 1 1 1    1  1 1 1 1  1
11 111 1111111  11 11  1    
1                     1 
111111 111111111   111
     1 1        1  1  
  1111 1111      1 1  
  1       1       11   
  111111111        1 
